WWWWWWWWWWWWWWWW
W..W.......W.o.W
W......BP......W
W.WoWW....WoWWWW
W..W.......W...W
W......o.W.o...W
WW..o....W..o..W
W.o.WWo...o.WW.W
W..............W
WWWWWWWWWWWWWWWW
