WWWWWWWWWWWWWWWW
W....WW...o...oW
W..............W
W....oWo.o.WW..W
W......WB...W..W
W....o.PWoW....W
W.WW.....WW..WWW
W............W.W
W.o..W....o....W
WWWWWWWWWWWWWWWW
