; Secret level
################
#..............#
#....o.o.o##B..#
#.o......#####.#
#.##.#o.o##..#.#
#.o.#...##.###.#
#....###.o###o.#
#...o...#...o..#
#.......P......#
################