; Level 6.
; No new techniques, just more open space and different possible paths.

################
#.......#......#
#.##.o.##o...o##
#.##.o.#.......#
#...P......o...#
#.o.o......B...#
#.#...o#.#o#.#o#
#.o.o..#.......#
#......##..o...#
################
