; Level 7.
; This should be another fairly difficult level. The player and block both
; have four possible opening moves.

################
#..#.#.........#
#..o.#.#.#.#..##
#..#o.......o.##
##.....#..o#...#
#....B.o..##.#.#
##o.P.o#..#..#.#
#......#.....o.#
#.o###....o..#.#
################
